{
    "type": {
        "layer1": {
            "data": [
                [0, 1, 1, 1, 1, 1, 1, 1, 1, 1, 0],
                [0, 1, 0, 0, 0, 0, 0, 0, 0, 1, 0],
                [0, 1, 0, 0, 0, 0, 0, 0, 0, 1, 0],
                [0, 1, 1, 1, 1, 1, 1, 1, 1, 1, 0],
                [0, 0, 0, 0, 0, 0, 0, 0, 0, 0, 0],
                [0, 0, 0, 0, 0, 0, 0, 0, 0, 0, 0],
                [0, 0, 0, 0, 0, 0, 0, 0, 0, 0, 0],
                [0, 0, 0, 0, 0, 0, 0, 0, 0, 0, 0],
                [0, 0, 0, 0, 0, 0, 0, 0, 0, 0, 0],
                [0, 0, 0, 0, 0, 0, 0, 0, 0, 0, 0],
                [0, 0, 0, 0, 0, 0, 0, 0, 0, 0, 0]
            ]
        },
        "layer2": {
            "data": [
                [0, 1, 1, 1, 1, 1, 1, 1, 1, 1, 0],
                [0, 1, 0, 0, 0, 0, 0, 0, 0, 1, 0],
                [0, 1, 0, 0, 0, 0, 0, 0, 0, 1, 0],
                [0, 1, 1, 1, 1, 1, 1, 1, 1, 1, 0],
                [0, 0, 0, 0, 0, 0, 0, 0, 0, 0, 0],
                [0, 0, 0, 0, 0, 0, 0, 0, 0, 0, 0],
                [0, 0, 0, 0, 0, 0, 0, 0, 0, 0, 0],
                [0, 0, 0, 0, 0, 0, 0, 0, 0, 0, 0],
                [0, 0, 0, 0, 0, 0, 0, 0, 0, 0, 0],
                [0, 0, 0, 0, 0, 0, 0, 0, 0, 0, 0],
                [0, 0, 0, 0, 0, 0, 0, 0, 0, 0, 0]
            ]
        }
    }
}